111111111111111111111111111111111111111111111111111111111111
1..........................................................1
1..........................................................1
1..........................................................1
1..........................................................1
1..........................................................1
1..........................................................1
1..........................................................1
1.......11111......11111............11111......11111.......1
1.......1..............1............1..............1.......1
1.......1..............1............1..............1.......1
1.......1..............1............1..............1.......1
1.......1..............1............1..............1.......1
1...................................1..............1.......1
1...................................1..............1.......1
1..............11...........................11.....1.......1
1..............11...........................11.....1.......1
1..................................................1.......1
1..................................................1.......1
1.......1..............11111111111111..............1.......1
1.......1..............1............1..............1.......1
1.......1..............1............1..............1.......1
1.......1..............1............1..............1.......1
1.......11111......11111............11111......11111.......1
1..........................................................1
1..........................................................1
1..........................................................1
1..P...........................................1111........1
1..............................................1111........1
1..............................................1111........1
1..........................................................1
111111111111111111111111111111111111111111111111111111111111